NO ./assets/wall_no.xpm
SO ./assets/wall_so.xpm
WE ./assets/wall_we.xpm
EA ./assets/wall_ea.xpm

F 210,100,0
C 225,30,0

        1111111111111111111111111
        1000000000110000000000001
        1011000001110000000000001
        1001000000000000000000001
111111111011000001110000000000001
100000000011000001110111111111111
11110111111111011100000010001
1111011111111101110101N010001
11000000110101011100000010001
11111111111111111111111111111
10000000000000001101010000001
1100000111010101 11101111000111
11110111 1110101 101111010001
11111111 1111111 111111111111
11111111 1111111
11111111 1111111
