
NO ./assets/wall_no.xpm
SO ./assets/wall_so.xpm
WE ./assets/wall_we.xpm
EA ./assets/wall_ea.xpm

F 98,70,33
C 77,159,240

111111111111111111111111111111
100000000000000010000000000001
111111100000000010000000000001
100000000000000000000000000001
100000000000001111111111000001
100000000000001110000000000001
111000000000001110000000000001111
1000000000000000000000000000W1111
100000000000000000000000000001
100000000000010000000000000001
100000000000000000000000000001
100000000000000000000000000001
100000000000000000000000000001
10000000000000000000000000001
100000000000000000000000000001
100000000000000000000000000001
111111111111111111111111111111
111111111111111111111111111111
111111111111111111111111111111
