11111111111111111111111
10000000000000000000001
10000000000000000000001
10000000000000P00000001
10000C00000000000000001
1000000000000000E000001
100000000000000EE000001
10000000000000000000001
11111111111111111111111