11111111111111111111111
10000000000000000000001
100000000CC0CC000000001
10000000C00C00C00000001
100000000C0P0C000000001
1000000000C0C0000000001
10000000000C00000000001
100000000000000000000E1
11111111111101111111111