11111111111111111111111
10000000000000000000001
10011100001110011100001
100000000000000P0000001
10000000000000000000001
10111100000000011110001
1000000000000C000000001
1000000000000000E000001
11111111111111111111111